  広いホールに入ると、そこはブラックジャックテーブル、「片腕の盗賊」スロットマシ	ン、ルーレット台でいっぱいだった。左の方を見ると大勝したらしい身なりのよい男のま	わりに人だかりができている。ここで遊ぶつもりのないあなたはデッキへ戻ることにし  	た。
                                                                                	ギリギリギリ!!!!!...歯ぎしりするような音が船の側面から聞こえると、タイタニック号	が傾き始めた。あなたは船が氷山と衝突したとすぐにわかった! この巨大な船はうめきな	がら揺れ、真っ暗な海へと沈んでゆくだろう。逃げようとする人々があらゆる出入口から	押し寄せてきてあたりは騒然としている。
  扉を開けると誰かがいた。
  タイタニック号が突然跳ね上がり、あなたはまるでマッチのようにデッキに叩きつけら	れ…そして気を失ってしまった! 怪我をした乗客たちは救命ボートに我先にと押し寄せて	いる。数分の後、あなたは船と共に沈んで行った。死は、思っていたほど苦しいものでは	なかったようだ。
  ボートの重みでロープは音を上げて切れた! ボートは海の上へと落ち、衝撃で水しぶき	が上がった。座席の下からさっきまでは見えなかった安全ベルトが現れた。
  タイタニック号が沈むと、雲のような熱い蒸気が吹き上がった。沈む船から脱出した人	達の声がかすかに遠くから聞こえる。
  救命ボートは得体の知れない力によって引き起こされた波で激しく揺れている。前の方	からまるで滝のような大きな音が聞こえる! あなたの行く手は周りよりも暗く見える。
  それが巨大な渦だと気づいたときにはもう遅かった! あなたは木の人形のように海に投	げ出されだ。あなたの最期の一呼吸は10%の空気と90%の水だった。これはまったく健康的	ではない。
  大きく揺れるボートの先に巨大な渦が見える!! 渦に飲み込まれたあなたは回転で座席 	に強く押し付けられ、気を失ってしまった…
You are given a life shocking jolt as you glimpse the image above you--it's the 	Titanic!!!  Resting not more than twenty feet above you is the bottom hull of   	the once mighty ship.  Dead bodies, fallen from the wreck, are scattered about  	the floor of the ice like cake decoration.  The horror is too real and you bow  	your head, unable to view the sight anymore.
  それはよくない決断だった! あなたが立っていた洞窟は、2秒間で500,000トンもの氷水	で満たされた。頭上のどこかにあったタイタニック号も流れ込み、あなたの亡骸の1メー 	トル手前で止まった。何と皮肉なことか。後に船を発見した者は誰でもあなたは船と共に	沈んだと考えるだろう!
  その言葉を言い終えると壁の六角形が震え出した! そして、すぐに壁全体がまるで生き	ているように揺れ始めた。洞窟が崩れるようだ! あなたの目の前で六角形が丸く変形し、	互いに結合できなくなり地面に落ちた。しばらくすると、壁を構成していた残りの丸いも	のも全て地面に落ち、そしてその衝撃で消えた。残されたのは新しい通路だけだ!
  洞窟の壁に刻まれた文字を読んだ:                                               	    『旅人よ気をつけろ――                                                      	        素晴らしき冒険者達は挑戦し…そして死んだ                                	      この壁は行く手を阻むであろう                                              	        この言葉を言わぬ限りは                                                  	          ケラヒ ヨチミ』
  壁は自然にできたものではないようだ。その異様な形態はまるで別世界のもののように	見える。壁は無数の小さな六角形でできていて、それぞれが完全に結合している。それは	完璧で――そして何かありそうだ。
Suddenly the flashlight flickers with its final burst of light...then goes out! 	You instantly realize the severity of the situation, and in a spasm of anger    	you toss the flashlight against the ground.  You listen with sorrow as many     	fragments hit the surrounding features.
  小さな洞窟の通路にいる。東の壁はあなたの奇妙な言葉で消え、新しい道が残された。	そこには別のトンネルが交差していて、出口が南西と北東にある。広い道は西へと続いて	いる。
Just as the rope snaps two of the ship's police walk around the forward deck on 	their routine patrol.  Of course, they are not amused by your foolhardy deed.   	They haul you off to a secluded cabin and bolt the door from the outside!       	                         
  You are inside one of the many cages within the lower cargo bay.  The cage    	door to the west is wide open.  Gooey slime and jelly drip from the cage bars.
  あなたは何があるかわからない谷底に向かってロープから飛び下りた! しばらくした  	後、あなたは地面に叩きつけられた。パキッという音と共に、両腕に激痛を感じた。その	ときの衝撃であなたの持ち物は飛び散った。
  目の前にあるものに気づいたとき、あなたは一瞬動けなくなった! それは巨大な金属の	円盤で、少なくとも幅40メートル、高さ5メートルはある。その上と周りのいたる所に大 	きな岩が見える。恐らく大昔に崩落したものだ。
突然、機械に命が吹き込まれたようになり、女性の声が部屋に響いた:                 	『あー…、おはようございます。私をオンにしたいのですか? ご存知の通り、私への最後	の命令から長い時間が経過しました。あの事故以来、私のメモリはやや不安定です。スク	リーンに表示したいならば、番号を入力してください。確認開始…ああ、4番スクリーン 	に興味深い情報があります。何をしているのですか? 早くしなさい! 』
......球..の..任務......標本....調..............................................	...........................  .... . ......   ......... ........        .      ..	... ....他..星..と..比...... .... ..... ....... ....... ......... ...... .. ....	....  . . 世... .      ... .... ..        地.....     ......................... 
..... .............. . . . .....  地..... ...... . . 着陸........未......... ...	... ....... 帰還.. .... 標本..獲し........ .. ... ... 収....... ..... ... . . . 	.........    . .     ..  ..  ..    ....         ................................	.... 了まで....還..ない... ...... .. ... ....... ........ .......球... ... 月...
............................................ ................ ..................	..      警..... >...>>.....>>  猛..青....物は ........ .....  . ..... ..険......	.....食....  ........ . .... .... .....  .....    .....       ....  . ..      ..	我... . .......査... ....           世.... ..種........... .    ...  .... ...  .
  .. 別..... ..... 時... 調査.....   生.... 進化...... ..... .. .... ... .......	............ .............   .  ...   ....... . .. .......  月...  .   ........ 	..2171年 ミュータ..ト.... 開発...... ...... .............   ... ... .... .......	............  .......  . . .      ...... ....................... ..   ..........
As you enter the engine room you feel a scorching, burning all over your skin-- 	suddenly you realize the shield plate is raised!!!  You dash for the button,    	but the heat and radiation is too overwhelming.  You callapse just short of     	safety...dead.
As you remove the alien suit you notice a dramatic rise in temperature,         	suddenly you notice the protective shield is in the raised position.            	Frantically, you rush to climb back into the suit, but the effort is wasted.    	Seconds later the intense heat and radiation overwhelms you...and you stumble   	to the floor, dead.
今度はもっとよく狙った。それは放物線を描き、ちょうど緑色のボタンに当たった。突  	然、頭上のランプが生き生きと輝き出し、暖かい光のシャワーがあなたを包んだ。腕の痛	みがまるで魔法のように消え去り、あなたの体は生き返ったようになった。ランプはしば	らく点滅し、そして消えた。
…突然、高熱が体を這い回るのを感じると、皮膚から真っ赤な血の泡が吹き出してきた。	あなたは出口へと急いだが、すぐに倒れてしまった。その2秒後…あなたは死んだ。
  あなたは一瞬ためらいボタンを押した。その直後、周りのものが消えてしまうような空	虚な感覚で体が満たされた。あなたの周りの世界がまるで高速撮影のように点滅し始め  	た。近くにあるものが曲がったりねじれたりしながら約1時間が経過した。突然全てが止 	まり…そしてあなたは豆の袋のように床に落ちた!
  ここは見たことがない場所だ。船の設備は消えてしまった! まだめまいがするが、近く	の手すりにつかまり立ち上がった。近くの水で顔を洗うと、ここは南北を向いた船橋だと	わかった。下は急流で、東の方向に流れている。どの方向を見ても地平線まで雲が立ち込	め、まるで人生の終わりのようだ。辺りのものは全て放置され朽ち果てている。
極地                                                                            	  あなたは深い雪に半分埋まっている。強い風で目も開けられない。近くに生き物の気配	を感じ辺りを見ると、巨大な白熊が立ちはだかっていた! あなたは逃げようとしたが雪が	深く、そして熊は素早かった。数秒後に熊はあなたを切り裂いた! あなたの亡骸は未来へ	の記憶となるだろう。
極地                                                                            	  突然地面がひっくり返り、あなたは氷の浮かぶ渦に飲み込まれた。周りの氷を見渡した	が、這い上がれる場所はない。あなたの体は寒さでマヒし始めた。必死で何度も氷の壁を	登ろうとしたが無駄だった。あなたは氷の墓標の下に沈んでいった。
砂漠のくぼ地                                                                    	  激しい暑さが襲い掛かってきた。立っているのがやっとだ。体を蟻が這い回るような苦	痛を感じる。辺りを見渡すと、そこは不毛な砂漠の金属片が散らばった巨大なクレーター	の中だった。まるで戦場だ。徐々に痛みが全身に回り…あなたは倒れ死んだ。
月面                                                                            	  強風に吹き飛ばされたが、あなたの肺の中は空気がなくカラッポだ! あなたは1メート 	ル程跳びあがった。辺りを見ても見慣れたものは何もない。だが、空の奇妙な青い物体を	見ると、あなたはそこが月面であるとわかるかもしれない。あなたの体は最期の瞬間まで	空気を求め続けた。
  突然巨大な獣が貨物から飛び出してきた。あなたが反応する前に手や体を触手で締め付	けられ、気を失ってしまった!
  突然地面が不規則に揺れ、あなたは背筋を這い回るような恐怖を感じた。揺れは30秒ほ	ど続いたが、次第に弱くなり収まった。
  注意深くクレーターの急斜面を下りている。あなたは途中で足を滑らせ転がり落ち、持	ち物を全て落としてしまった! 探して拾わなければならない…
ゆっくりと、しかし確実に、急斜面を張り付くように登った。どうにか出ることができ  	た。
You leap from the bridge into the fast flowing stream below.  The rapid current 	tosses you around like a twig and finally drags you underneath.
突然背後の岩陰からフードをした人間のような姿が飛び出しあなたの持ち物を掴み取っ  	た! それはあなたが冷静さを取り戻す前にクレーターの東の端に駆け上がった。
判断が正しいかはわからないが、あなたた明るいオレンジの光線を通った。電気的なバリ	アを通過すると、突然あなたの手足が見えなくなった。次の瞬間、あなたは別の場所に転	送された…
天井の隙間から床の隙間へと向かう明るいオレンジ色の光線は、まるで生きているかのよ	うに動いている。光線の幅は大きな扉ほどだ。光線のとなりの壁には看板がかかってい  	る。
小さな看板を見た:                                                               	                     各階の案内                                                 	                     1階:  広告                                                 	                     2階:  放送                                                 	                     3階:  メンテナンス                                         	                     4階:  ビジネス
フードをした、ミュータントのような生き物が背後の岩から突然現れあなたの持ち物を奪	い取ろうとしてきた! あなたは抵抗したが、クレーターの端に追いやられた。あなたはク	レーターの急斜面を転がり落ち、ミュータントは逃げ去った。
  あなたは錠前の高さに身を屈め、鍵穴に針金を差し込んだ。鍵を外すため、数分の間針	金を抜き差ししたりひねったりした。その努力は…カチャッ…キャビネットが開き実っ  	た。
  Below you lies a small, muddy lake, probably nearing the end of its existence.	A very small stream breaks off to the southwest, but fades into nothing within  	a quarter of a mile.
  Below you appears to be the remains of a small town.  The entire area is      	riddled with small pits, craters and depressions.  In your mind you picture     	what might of happened here, the thought is not a pretty one.
  You've entered a desert area, except for the lack of rolling sand dunes.  The 	whole area does not seem natural, as if it was once a pasture teaming with life.	On the horizon you can see a few mountains.
  You are above a desert area that is covered with craters and pits, all        	relatively small in comparison with others you've seen.  Mixed in with the sand 	you can barely see jagged pieces of concrete and other rubble.                  	On the horizon you can see a few mountains.
  You are above the fast flowing river that passes by the large building and    	broken bridge.  The river flows from the southwest and bends north here.  A     	half mile north, though, the river curves hard to the right again and fades in  	the distance.
  You are flying above a stream that probably comes from the mountains in the   	distance.  The stream doesn't hold much water and looks like it's about to run  	dry pretty soon.
  Below is a very small town that probably had a population less than 50 people.	The place looks deserted now, abandoned vehicles of some kind litter the roads. 	Several roads exit the town, heading off in random, appearently pointless       	directions.
  You are above one of the many mountains in this area.  A small, slow flowing  	streams flows from a cave at the base of one of the mountains here.  All around 	you the desert-like landscape spreads to the horizon.  These mountains are the  	only break in the flatness.  The clouds above you cast eerie shadow on the      	mountain sides.
  You are flying above a huge crater like the one by the broken bridge.  Rubble 	is scattered all around the crater's edges, mixed with large boulders.
  Below you are a few small hills that build up to the mountains in the near    	distance.  A slim stream winds its way through the tangled arrangement and      	bends towards the west into the flatland area.
  Below is a small crack in the Earth forming a shallow canyon, about 100 yards 	across and a half mile long.  The large shadows of the thich, hazy clouds       	blocks the light enough so that you can't see into the canyon very well.
  The desert-like area blends into a less sandy area here, and forms a small    	region of hard flatland.  This might have been a large, shallow lake in the     	past, fed from streams that came from the mountains in the distance.
  You are above a large dry lake area, the cracked clay pan area gives a clear  	indication to the once water-filled area.  The shadows of clouds roam across    	the empty area, heading southward.
  You are above a vast desert area.  Above you is a thick layer of clouds,      	which blocks out at least 50 oercent of the sun's light.  In the distance you   	can see a small mountain range.
  You are above a concrete bridge that crosses the same river that passes the   	large building.  This bridge is in fairly good shape and provides a complete    	passage for the road that meets it.  The road heads northward, but slowly       	curves to the east.
Without warning, the shuttle's engine begins to humm with activity, suddenly you	are jolted back into the seat as the shuttle raises from the roof and high into 	the sky.  You finally level out about a half of a mile below the thick cloud    	cover...
Abruptly the steady humming of the shuttle's engine ceases!  The shuttle tips   	over nose first and plummits toward Earth.  The tremendous gravitational forces 	push all of your limbs back against the seat.  You watch helplessly, and in     	terror as the ground rushes closer...and closer...and closer...and CRASH!!!
As you move the lever an unforseen panel in the roof slowly slides open.  A     	great rush of wind whips your hair around as you watch.  Suddenly your seat     	snaps upward, ejecting you from the shuttle!!!  You glide freely to the Earth,  	enjoying its natural beauty as you fall.  Maybe, you wonder, you were supposed  	to have the parachute before you used the lever...SPLAT!!!
The shuttle's engine seems to strain and vibrate as the nose angles upward.     	You are again forced back into your seat as the shuttle moves closer to the     	thick layer of clouds above.  Turbulence rocks the shuttle around as it enters  	the clouds, you can see nothing.  Within moments, however, the shuttle rises    	above the cloud barrier.  You are greeted with an amazing and unbelievable      	sight...a gigantic floating structure, resembling a large city.
As you take the key from its slot the shuttle's engine whines, then stops!  The 	vehicle suddenly tilts forward, spiraling towards the ground.  The tremendous   	gravitational forces prevent you from putting the key back in.  You watch with  	horror as the ground moves closer...and closer...and closer...and CRASH!!!
As you remove the helmet from your head the shuttle begins to tilt to the side. 	Suddenly it begins to spiral down to Earth!  The whiplash caused you to drop the	helmet on the floor.  And the great force of the fall prevents you from leaning 	over and picking it up.  You watch helplessly, and with frustration, as the     	shuttle plummits closer to the ground, and closer...and closer...and CRASH!!!
The shuttle tilts forward a little and heads southward, dropping slightly in    	altitude.  As you move closer to the landing area you notice some rubble        	directly in your path.  Too late to react, though, you brace yourself against   	the seat as the shuttle hits the jagged piece of concrete...the shuttle slides  	for about 60 feet before coming to rest.  As you check yourself over, you       	notice a thin whisp of smoke coming from the shuttle's controls.
  From here you can see many large buildings and towers, with an interlaced     	network of roads and tubes weaving in an around the other structures.  A bright 	glow radiates downward from under the city, disappearing into the dusty clouds.
  You enter the room thinking about the distinctively repulsive smell.  From the	corner of the room you hear a strange gurgling noise, look up, and freeze in    	your tracks!  Standing there, with slime dripping from its gapping mouth, is a  	creature groveling in the food supply.  Its three arms shoveling food in its    	jaws with timed precision.  Hearing your sweat drip on the floor, the creature  	looks up, sees you, and lunges toward you with burning eyes!
  The large monster is about eight feet tall, with three long arms fitted with  	thick claws.  Its slobbering jaws drip with slime.
The slobbering monster dives at your feet and catches your leg with one of its  	clawed hands!  As it climbs to its feet though, you fly into a wild struggle    	and just manage to shake loose.  You jump forward, perform an acrobatic roll,   	spring to your feet, and sprint away!  The creature, however, is still right    	behind you.
The creature, with its deadly clawed arms swinging wildly, follows you stride   	for stride.  It's sharp claws nipping at you back!
A mysterious figure begins to appear in front of you, forming out of thin air!  	You realize from its hulking shape that it's the creature, it must of been too  	close to you when you transported back, you deduce.  Within seconds the full    	body of the creature appears before you.  However, the creature seems to stumble	around for a moment, possibly a little dizzle from its unexpected ride!
An intense heat seems to engulf the room as everything around you begins to take	on a glow of its own, including the alien creature!  The creature's eyes bulge  	as it realizes its situation.  Its three arms shrivel as it roars in pain.      	Before your eyes the monster melts into a bubbling puddle of gooey remains!  As 	the puddle sreads over the floor a small tape cartridge is revealed,            	appearently devoured by the creature earlier.
On the screen you see a series of photos flash by, all of which look like       	pictures of cities.  The film abruptly stops on a particular picture you easily 	recognize, it's a photo of a park just outside San Francisco!!!  In the corner  	of the screen is the number 1933.
As you reach for the tan colored button the alien creature lunges at you and    	bumps you to the ground.  The struggle does not last long.  The monster feasts  	on your meaty bones!
The pictures on the screen have stopped on a familiar photo of a park just      	outside San Francisco!  Appearently the aliens were using the time chair to     	examine future Earth cultures.  A number in the corner of the screen looks like 	a date!  The number is 1933.
You hit a soft patch of grass, look up, and view several tall, green trees,     	swaying in a cool harbor breeze.  You easily recognize this place as the same   	spot as in the screen photo!  Several people are staring at you from the        	distance, somewhat amazed by your unannounced appearance!  You pick yourself up 	a begin walking toward a police station on the corner.  As you walk you wonder  	who will be crazy enough to believe your story!!
                                                                                	The alien creatures lurks around the lower bay until it sees you trapped in the 	cage.  With its three clawed arms slashing away it shreds you into little bits, 	which are carefully cleaned up by the resident rats!
                                                                                	The monster grabs with two of its three clawed arms and rips you to shreds with 	its middle arm.  Hours later you provide a royal feast for the resident rats!
                                                                                	The monster leaps across the room and knocks you to the ground.  You struggle   	with it as it wraps you up in its arms and begins feasting on your tasty skin!  	A few hours later your discarded bones provide the perfect start to a rat's     	nest.
The creature reaches out with one of its three clawed hands and grabs your arm. 	You try to break free, but the monster is too strong.  It breaks your arms and  	legs so that you can't get away, then the slobbering monster moves in for the   	kill.  You close your eyes and....
                 - - - - - - - - - 警   告 - - - - - - - - -                    	                                                                                	このレバーは緊急時専用である。パイロットは必ず装着すること。このレバーはオモチャ	ではない!!! 他に手段がない場合のみ使用すること。危険!!!!!!
  You are inside a shuttle that is flying high above the ground.  In front of   	you is control panel covered with complicated looking equipment.  Notable is an 	oversized white button with a keyhole below it.  Also catching you attention is 	a large lever coming from the floor, and a bright red sign to the right of the  	lever.
